2222222222222222222222222222222222222222222222222222222222222222222222222222222222222222222222222222
2220022222222222222222002222222200002202222222220022220000022222222222222222222222222000002222222222
2211000202200000022000000022000000000000220002000002200000000022002222200000022000000002222222002022
2220100000000000000000000000000000000000000000000000000000000000000000000000000000000000000000000022
2222000000000000000000000000000000000000000000000000000000000000000000000000000000000000000000000222
2222000000000000000000000000000000000000000000000000000000000000000000000000000000000000000000000222
2200000000000000000000000000000000000000000000000000000000000000000000000000000000000000000000002202
2000000000000000000000000000000000000000000000000000000000000000000000000000000000000000000000000002
2220000000000000000000000000000000000000000000000000000000000000000000000000000000000000000000000222
2222000000000000000000000000000000000000000000000000000000000000000000000000000000000000000000002222
2200000000000000000000000000000000000000000000000000000000000000000000000000000000000000000000000022
2200000000000000000000000000000000000000000000000000000000000000000000000000000000000000000000000022
2000000000000000000000000000000000000000000000000000000000000000000000000000000000000000000000000022
2220000000000000000000000000000000000000000000000000000000000000000000000000000000000000000000000022
2222000000000000000000000000000000000000000000000000000000000000000000000000000000000000000000000222
2222000000000000000000000000000000000000000000000000000000000000000000000000000000000000000000000222
2200000000000000000000000000000000000000000000000000000000000000000000000000000000000000000000002202
2000000000000000000000000000000000000000000000000000000000000000000000000000000000000000000000000022
2220000000000000000000000000000000000000000000000000000000000000000000000000000000000000000000000222
2222000000000000000000000000000000000000000000000000000000000000000000000000000000000000000000002222
2200000000000000000000000000000000000000000000000000000000000000000000000000000000000000000000000022
2200000000000000000000000000000000000000000000000000000000000000000000000000000000000000000000000222
2220000000000000000000000000000000000000000000000000000000000000000000000000000000000000000000000222
2220000000000000000000000000000000000000000000000000000000000000000000000000000000000000000000000022
2222000000000000000000000000000000000000000000000000000000000000000000000000000000000000000000000222
2222000000000000000000000000000000000000000000000000000000000000000000000000000000000000000000002222
2200000000000000000000000000000000000000000000000000000000000000000000000000000000000000000000002202
2000000000000000000000000000000000000000000000000000000000000000000000000000000000000000000000000022
2220000000000000000000000000000000000000000000000000000000000000000000000000000000000000000000002222
2200000000000000000000000000000000000000000000000000000000000000000000000000000000000000000000002222
2200000000000000000000000000000000000000000000000000000000000000000000000000000000000000000000000022
2200000000000000000000000000000000000000000000000000000000000000000000000000000000000000000000000022
2000000000000000000000000000000000000000000000000000000000000000000000000000000000000000000000000222
2220000000000000000000000000000000000000000000000000000000000000000000000000000000000000000000000022
2200000000000000000000000000000000000000000000000000000000000000000000000000000000000000000000000222
2222000000000000000000000000000000000000000000000000000000000000000000000000000000000000000000000222
2200000000000000000000000000000000000000000000000000000000000000000000000000000000000000000000002202
2000000000000000000000000000000000000000000000000000000000000000000000000000000000000000000000000222
2200000000000000000000000000000000000000000000000000000000000000000000000000000000000000000000000222
2222000000000000000000000000000000000000000000000000000000000000000000000000000000000000000000000222
2202000000000000000000000000000000000000000000000000000000000000000000000000000000000000000000000022
2200000000000000000000000000000000000000000000000000000000000000000000000000000000000000000000000022
2002000000000000000000000000000000000000000000000000000000000000000000000000000000000000000000002222
2220000000000000000000000000000000000000000000000000000000000000000000000000000000000000000000000022
2220000000000000000000000000000000000000000000000000000000000000000000000000000000000000000000000222
2200000000000000000000000000000000000000000000000000000000000000000000000000000000000000000000000222
2200000000000000000000000000000000000000000000000000000000000000000000000000000000000000000000000202
2000000000000000000000000000000000000000000000000000000000000000000000000000000000000000000000000002
2220000000000000000000000000000000000000000000000000000000000000000000000000000000000000000000000222
2222000000000000000000000000000000000000000000000000000000000000000000000000000000000000000000000022
2200000000000000000000000000000000000000000000000000000000000000000000000000000000000000000000000002
2222000000000000000000000000000000000000000000000000000000000000000000000000000000000000000000000002
2200000000000000000000000000000000000000000000000000000000000000000000000000000000000000000000000002
2220000000000000000000000000000000000000000000000000000000000000000000000000000000000000000000000022
2222000000000000000000000000000000000000000000000000000000000000000000000000000000000000000000000222
2222000000000000000000000000000000000000000000000000000000000000000000000000000000000000000000000222
2200000000000000000000000000000000000000000000000000000000000000000000000000000000000000000000002202
2220000000000000000000000000000000000000000000000000000000000000000000000000000000000000000000000002
2220000000000000000000000000000000000000000000000000000000000000000000000000000000000000000000000222
2222000000000000000000000000000000000000000000000000000000000000000000000000000000000000000000002222
2200000000000000000000000000000000000000000000000000000000000000000000000000000000000000000000000002
2200000000000000000000000000000000000000000000000000000000000000000000000000000000000000000000000002
2002000000000000000000000000000000000000000000000000000000000000000000000000000000000000000000000002
2220000000000000000000000000000000000000000000000000000000000000000000000000000000000000000000000022
2222000000000000000000000000000000000000000000000000000000000000000000000000000000000000000000000222
2002000000000000000000000000000000000000000000000000000000000000000000000000000000000000000000000222
2200000000000000000000000000000000000000000000000000000000000000000000000000000000000000000000002202
2000000000000000000000000000000000000000000000000000000000000000000000000000000000000000000000000022
2220000000000000000000000000000000000000000000000000000000000000000000000000000000000000000000000222
2222000000000000000000000000000000000000000000000000000000000000000000000000000000000000000000002222
2200000000000000000000000000000000000000000000000000000000000000000000000000000000000000000000000022
2200000000000000000000000000000000000000000000000000000000000000000000000000000000000000000000000222
2000000000000000000000000000000000000000000000000000000000000000000000000000000000000000000000000022
2220000000000000000000000000000000000000000000000000000000000000000000000000000000000000000000000022
2222000000000000000000000000000000000000000000000000000000000000000000000000000000000000000000000222
2000000000000000000000000000000000000000000000000000000000000000000000000000000000000000000000000222
2200000000000000000000000000000000000000000000000000000000000000000000000000000000000000000000002202
2000000000000000000000000000000000000000000000000000000000000000000000000000000000000000000000000002
2220000000000000000000000000000000000000000000000000000000000000000000000000000000000000000000000222
2222000000000000000000000000000000000000000000000000000000000000000000000000000000000000000000002222
2200000000000000000000000000000000000000000000000000000000000000000000000000000000000000000000002222
2200000000000000000000000000000000000000000000000000000000000000000000000000000000000000000000000022
2020000000000000000000000000000000000000000000000000000000000000000000000000000000000000000000000022
2220000000000000000000000000000000000000000000000000000000000000000000000000000000000000000000002022
2222000000000000000000000000000000000000000000000000000000000000000000000000000000000000000000000222
2222000000000000000000000000000000000000000000000000000000000000000000000000000000000000000000000222
2200000000000000000000000000000000000000000000000000000000000000000000000000000000000000000000022202
2000000000000000000000000000000000000000000000000000000000000000000000000000000000000000000000000222
2220000000000000000000000000000000000000000000000000000000000000000000000000000000000000000000000222
2022000000000000000000000000000000000000000000000000000000000000000000000000000000000000000000022222
2200000000000000000000000000000000000000000000000000000000000000000000000000000000000000000000002222
2200000000000000000000000000000000000000000000000000000000000000000000000000000000000000000000000222
2000000000000000000000000000000000000000000000000000000000000000000000000000000000000000000000000222
2020000000000000000000000000000000000000000000000000000000000000000000000000000000000000000000000022
2220000000000000000000000000000000000000000000000000000000000000000000000000000000000000000000000222
2220000000000000000000000000000000000000000000000000000000000000000000000000000000000000000000002222
2220000000000000000000000000000000000000000000000000000000000000000000000000000000000000000000000022
2200000202200000022000000022000000000000220002000002200000000022002222200000022000000002222222002222
2220022222222222222222002222222200002202222222220022220000022222222222222222222222222000002222222022
2222222222222222222222222222222222222222222222222222222222222222222222222222222222222222222222222222